tilemap-start
	solid 1
	width 21
	height 15
	layer 0
	tiles-start
		row  1  1  1  1  1  1  1  1  4  4  4  4  4  1  1  1  1  1  1  1  1
		row  1  2  2  2  2  2  2  2  2  2  2  2  2  2  2  2  2  2  2  2  1
		row  1  2  2  2  2  2  2  2  2  2  2  2  2  2  2  2  2  2  2  2  1
		row  1  2  2  2  2  2  2  2  2  2  2  2  2  2  2  2  2  2  2  2  1
		row  1  2  2  2  2  2  2  2  2  2  2  2  2  2  2  2  2  2  2  2  1
		row  4  2  2  2  2  2  2  2  2  2  2  2  2  2  2  2  2  2  2  2  4
		row  4  2  2  2  2  2  2  2  2  2  2  2  2  2  2  2  2  2  2  2  4
		row  4  2  2  2  2  2  2  2  2  2  2  2  2  2  2  2  2  2  2  2  4
		row  4  2  2  2  2  2  2  2  2  2  2  2  2  2  2  2  2  2  2  2  4
		row  4  2  2  2  2  2  2  2  2  2  2  2  2  2  2  2  2  2  2  2  4
		row  1  2  2  2  2  2  2  2  2  2  2  2  2  2  2  2  2  2  2  2  1
		row  1  2  2  2  2  2  2  2  2  2  2  2  2  2  2  2  2  2  2  2  1
		row  1  2  2  2  2  2  2  2  2  2  2  2  2  2  2  2  2  2  2  2  1
		row  1  2  2  2  2  2  2  2  2  2  2  2  2  2  2  2  2  2  2  2  1
		row  1  1  1  1  1  1  1  1  4  4  4  4  4  1  1  1  1  1  1  1  1
	tiles-end
tilemap-end